3 3 3 3 3 3 3 3 3 3 3 3 3 3 3 3
3 0 1 0 1 0 1 0 1 0 1 0 1 0 1 3
3 1 0 1 0 1 0 1 0 1 0 1 0 1 0 3
3 0 1 0 1 0 1 0 1 0 1 0 1 0 1 3
3 1 0 1 0 1 0 1 0 1 0 1 0 1 6 3
3 4 1 0 1 0 1 0 1 0 1 0 1 0 1 3
3 1 4 1 0 1 0 1 0 1 0 1 0 1 0 3
3 0 1 0 1 0 1 0 1 0 1 0 1 0 6 3
3 1 0 1 0 1 0 1 0 1 0 1 0 1 0 3
3 0 1 0 2 2 2 2 2 2 2 0 1 5 1 3
3 5 0 2 2 2 2 2 2 2 2 2 1 1 0 3
3 3 2 2 2 2 2 2 2 2 2 2 2 2 3 3